1 1 1 1 1 1 1 1 1 1 1 1 1 1 1 1 1 1 1 1 1 8 1 1 1 1 1 1 1 1 1 1 1 1 1 1 1 1 1 1
1 1 1 1 1 1 1 1 1 1 1 1 1 1 1 1 1 1 1 1 1 8 1 1 1 1 1 1 1 1 1 1 1 1 1 1 1 1 1 1
1 1 9 8 8 8 8 8 8 8 8 8 8 8 8 8 8 8 8 1 1 8 1 1 8 8 8 8 8 8 8 8 8 8 8 8 8 8 1 1
1 1 8 1 1 1 1 1 1 1 1 1 1 1 1 1 1 1 8 1 1 8 1 1 8 1 1 1 1 1 1 1 1 1 1 1 1 8 1 1
1 1 8 1 1 1 1 1 1 1 1 1 1 1 1 1 1 1 8 1 1 8 1 1 8 1 1 1 1 1 1 1 1 1 1 1 1 8 1 1
1 1 8 8 8 8 8 8 8 8 8 8 8 8 8 8 8 8 8 8 8 8 8 8 8 8 8 8 8 8 8 8 8 8 8 8 8 8 1 1
1 1 1 1 1 8 1 1 1 1 1 1 1 1 1 1 8 1 1 1 1 1 1 1 1 8 1 1 1 1 1 1 1 1 8 1 1 1 1 1
1 1 1 1 1 8 1 1 1 1 1 1 1 1 1 1 8 1 1 1 1 1 1 1 1 8 1 1 1 1 1 1 1 1 8 1 1 1 1 1
1 1 8 8 8 8 8 8 8 8 8 8 8 8 8 8 8 8 8 8 8 8 8 8 8 8 8 8 8 8 8 8 8 8 8 8 8 9 1 1
1 1 8 1 1 1 1 1 1 8 1 1 7 6 1 1 8 1 1 1 1 1 1 8 1 1 1 1 1 1 8 1 1 1 1 1 1 8 1 1
1 1 8 1 1 1 1 1 1 8 1 1 0 0 1 1 8 1 1 1 1 1 1 8 1 1 1 1 1 1 8 1 1 1 1 1 1 8 1 1
1 1 8 1 1 13 8 8 8 8 1 1 4 5 1 1 8 1 1 5 0 1 1 8 1 1 0 5 1 1 8 1 1 5 0 1 1 8 1 1
1 1 8 1 1 1 1 1 1 8 1 1 0 0 1 1 8 1 1 1 1 1 1 8 1 1 1 1 1 1 8 1 1 1 1 1 1 8 1 1
1 1 8 1 1 1 1 1 1 8 1 1 0 0 1 1 8 1 1 1 1 1 1 8 1 1 1 1 1 1 8 1 1 1 1 1 1 8 1 1
1 1 8 8 8 8 8 1 1 8 1 1 0 19 1 1 8 1 1 8 8 8 8 8 1 1 10 1 1 8 8 1 1 8 8 1 1 8 1 1
1 1 8 1 1 1 1 1 1 8 1 1 1 1 1 1 8 1 1 8 1 1 1 8 1 1 8 1 1 1 8 1 1 8 8 1 1 8 1 1
1 1 8 1 1 1 1 1 1 8 1 1 1 1 1 1 8 1 1 8 1 1 1 8 1 1 8 1 1 1 8 1 1 8 8 1 1 8 1 1
1 1 8 8 8 8 8 8 8 8 8 8 8 8 8 8 8 8 8 8 1 1 1 8 8 8 8 8 8 8 8 8 8 8 8 8 8 8 1 1
1 1 1 1 1 8 1 1 1 1 1 8 1 1 8 1 1 1 1 1 1 1 1 1 1 1 1 1 1 1 1 1 8 1 1 8 1 1 1 1
1 1 1 1 1 8 1 1 1 1 1 8 1 1 8 1 1 1 1 1 1 1 1 1 1 1 1 1 1 1 1 1 8 1 1 8 1 1 1 1
1 1 9 1 1 8 8 8 8 8 8 8 1 1 8 1 1 8 8 8 8 2 8 8 8 8 8 8 8 1 1 1 8 1 1 8 1 1 1 1
1 1 8 1 1 1 1 1 1 1 1 8 1 1 8 1 1 8 1 1 1 1 1 1 1 1 1 1 8 8 8 8 8 1 1 8 8 8 8 1
1 1 8 1 1 1 1 1 1 1 1 8 1 1 8 1 1 8 1 1 1 1 1 1 1 1 1 1 8 1 1 1 1 1 1 1 1 1 8 1
1 1 8 8 8 8 8 8 8 8 8 8 1 1 8 8 8 8 8 8 8 8 8 8 8 9 1 1 8 1 1 1 1 1 1 1 1 1 8 1
1 1 1 1 1 1 1 1 1 1 1 1 1 1 1 1 1 1 1 1 1 8 1 1 1 1 1 1 8 8 8 8 8 8 8 8 8 8 8 1
1 1 1 1 1 1 1 1 1 1 1 1 1 1 1 1 1 1 1 1 1 8 1 1 1 1 1 1 1 1 1 1 1 1 1 1 1 1 1 1
1 1 1 1 1 1 1 1 1 1 1 1 1 1 1 1 1 1 1 1 1 8 1 1 1 1 1 1 1 1 1 1 1 1 1 1 1 1 1 1
