1 1 1 1 1 1 1 1 1 1 1 1 1 1 1 1 1 1 1 1 1 1 1 1 1 1 1 1 1 1 1 1 1 1 1 1 1 1 1 1
1 9 8 8 8 8 8 8 8 8 8 8 8 1 1 1 1 1 1 1 1 1 1 1 1 1 1 8 8 8 11 8 8 8 8 8 8 8 9 1
1 8 1 1 1 1 1 1 1 1 1 1 8 1 1 1 1 1 1 1 1 1 1 1 1 1 1 8 1 1 1 1 1 1 1 1 1 1 8 1
1 8 1 1 1 1 1 1 1 1 1 1 8 8 8 8 8 8 8 8 8 8 8 8 8 8 8 8 1 1 1 1 1 1 1 1 1 1 8 1
1 8 8 8 8 8 8 8 8 8 8 8 8 1 1 1 1 1 8 1 1 8 1 1 1 1 1 8 8 8 8 8 8 8 8 8 8 8 8 1
1 8 1 1 1 1 1 1 1 8 1 1 1 1 1 1 1 1 8 1 1 8 1 1 1 1 1 1 1 1 8 1 1 1 1 1 1 1 8 1
1 8 1 1 1 1 1 1 1 8 1 1 1 1 1 8 8 8 8 1 1 8 8 8 8 1 1 1 1 1 8 1 1 1 1 1 1 1 8 1
1 8 8 8 8 8 1 1 1 8 8 8 8 1 1 8 1 1 1 1 1 1 1 1 8 1 1 8 8 8 8 1 1 1 8 8 8 8 8 1
1 1 1 1 1 8 1 1 1 1 1 1 8 1 1 8 1 1 1 1 1 1 1 1 8 1 1 8 1 1 1 1 1 1 8 1 1 1 1 1
1 1 1 1 1 8 1 1 1 1 1 1 8 1 1 8 8 8 8 8 8 8 8 8 8 1 1 8 1 1 1 1 1 1 8 1 1 1 1 1
1 1 1 1 1 8 1 1 1 8 8 8 8 8 8 8 1 1 1 8 8 1 1 1 8 8 8 8 8 8 8 1 1 1 8 1 1 1 1 1
1 1 1 1 1 8 1 1 1 8 1 1 1 1 1 8 1 1 1 8 19 1 1 1 8 1 1 1 1 1 8 1 1 1 8 1 1 1 1 1
8 8 8 8 8 8 8 8 8 8 1 1 1 1 1 8 1 1 6 7 5 4 1 1 8 1 1 1 1 1 8 8 8 8 8 8 8 8 8 8
1 1 1 1 1 8 1 1 1 8 8 8 8 8 8 8 1 1 1 1 1 1 1 1 8 8 8 8 8 8 8 1 1 1 8 1 1 1 1 1
1 1 1 1 1 8 1 1 1 8 1 1 1 1 1 8 1 1 1 1 1 1 1 1 8 1 1 1 1 1 8 1 1 1 8 1 1 1 1 1
1 1 1 1 1 8 1 1 1 8 1 1 1 1 1 8 8 8 8 8 8 8 8 8 8 1 1 1 1 1 8 1 1 1 8 1 1 1 1 1
1 8 8 8 12 8 8 8 8 8 8 8 8 1 1 1 1 8 1 1 1 1 8 1 1 1 1 8 8 8 8 8 8 8 8 8 8 8 8 1
1 8 1 1 1 1 8 1 1 1 1 1 8 1 1 1 1 8 1 1 1 1 8 1 1 1 1 8 1 1 1 1 1 8 1 1 1 1 8 1
1 8 1 1 1 1 8 1 1 1 1 1 8 1 1 1 1 8 1 1 1 1 8 1 1 1 1 8 1 1 1 1 1 8 1 1 1 1 8 1
1 9 8 8 1 1 8 8 8 8 8 8 8 8 8 8 8 8 1 1 1 1 8 8 8 8 8 8 8 8 8 8 8 8 1 1 8 8 9 1
1 1 1 8 1 1 8 1 1 8 1 1 1 1 1 1 1 8 1 1 1 1 8 1 1 1 1 1 1 1 8 1 1 8 1 1 8 1 1 1
1 1 1 8 1 1 8 1 1 8 1 1 1 1 1 1 1 8 1 1 1 1 8 1 1 1 1 1 1 1 8 1 1 8 1 1 8 1 1 1
1 8 8 8 8 8 8 1 1 8 8 8 8 8 8 8 8 8 8 8 2 8 8 8 8 1 1 8 8 8 8 1 1 8 8 8 8 8 8 1
1 8 1 1 1 1 1 1 1 1 1 1 1 1 1 8 1 1 1 1 1 1 1 1 8 1 1 8 1 1 1 1 1 1 1 1 1 1 8 1
1 8 1 1 1 1 1 1 1 1 1 1 1 1 1 8 1 1 1 1 1 1 1 1 8 1 1 8 1 1 1 1 1 1 1 1 1 1 8 1
1 8 8 8 8 8 8 8 8 8 8 8 8 8 8 8 8 8 8 8 8 8 8 8 8 8 8 8 8 8 8 8 8 8 8 8 8 8 8 1
1 1 1 1 1 1 1 1 1 1 1 1 1 1 1 1 1 1 1 1 1 1 1 1 1 1 1 1 1 1 1 1 1 1 1 1 1 1 1 1
