1 1 1 1 1 1 1 1 1 1 1 1 8 1 1 1 1 1 1 1 1 1 1 1 1 1 1 8 1 1 1 1 1 1 1 1 1 1 1 1
8 8 8 8 8 8 8 8 8 8 8 8 8 1 1 8 8 8 8 8 8 8 8 8 8 1 1 8 8 8 11 8 8 8 8 8 8 8 9 8
1 8 1 1 1 1 1 1 1 1 1 1 8 1 1 8 1 1 1 1 1 1 1 1 8 1 1 8 1 1 1 1 1 1 1 1 1 1 8 1
1 8 1 1 1 1 1 1 1 1 1 1 8 8 8 8 1 1 1 1 1 1 1 1 8 8 8 8 1 1 1 1 1 1 1 1 1 1 8 1
8 8 8 8 8 8 8 8 8 8 8 8 8 1 1 8 1 1 1 1 1 1 1 1 8 1 1 8 8 8 8 8 8 8 8 8 8 8 8 8
1 8 1 1 1 1 1 1 1 8 1 1 1 1 1 8 8 8 8 8 8 8 8 8 8 1 1 1 1 1 8 1 1 1 1 1 1 1 8 1
1 8 1 1 1 1 1 1 1 8 1 1 1 1 1 8 1 1 1 0 0 1 1 1 8 1 1 1 1 1 8 1 1 1 1 1 1 1 8 1
1 8 8 8 8 8 8 8 8 8 8 8 8 8 8 8 1 1 1 0 0 1 1 1 8 8 8 8 8 8 8 8 8 8 8 8 8 8 8 1
1 1 1 1 1 8 1 1 1 1 1 1 8 1 1 8 1 1 16 4 5 12 1 1 8 1 1 8 1 1 1 1 1 1 8 1 1 1 1 1
1 1 1 1 1 8 1 1 1 1 1 1 8 1 1 8 1 1 1 1 1 1 1 1 8 1 1 8 1 1 1 1 1 1 8 1 1 1 1 1
8 8 8 8 8 8 1 1 1 8 8 8 8 1 1 8 1 1 1 1 1 1 1 1 8 1 1 8 8 8 8 1 1 1 8 8 8 8 8 8
1 8 1 1 1 8 1 1 1 8 1 1 1 1 1 8 8 8 8 8 8 8 8 8 8 1 1 1 1 1 8 1 1 1 8 1 1 1 8 1
1 8 1 1 1 8 1 1 1 8 1 1 1 1 1 8 1 1 1 1 1 1 1 1 8 1 1 1 1 1 8 1 1 1 8 1 1 1 8 1
1 8 1 1 1 8 8 8 8 8 8 8 8 8 8 8 1 1 1 1 1 1 1 1 8 8 8 8 8 8 8 8 8 8 8 1 1 1 8 1
1 8 1 1 1 1 1 1 1 8 1 1 1 1 1 8 1 1 10 1 1 10 1 1 8 1 1 1 1 1 8 1 1 1 1 1 1 1 8 1
1 8 1 1 1 1 1 1 1 8 1 1 1 1 1 8 8 8 8 8 8 8 8 8 8 1 1 1 1 1 8 1 1 1 1 1 1 1 8 1
1 8 8 8 12 8 8 8 8 8 8 8 8 1 1 1 1 1 8 1 1 8 1 1 1 1 1 8 8 8 8 8 8 8 8 8 8 8 8 1
1 8 1 1 1 1 8 1 1 1 1 1 8 1 1 1 1 1 8 1 1 8 1 1 1 1 1 8 1 1 1 1 1 8 1 1 1 1 8 1
1 8 1 1 1 1 8 1 1 1 1 1 8 1 1 1 1 1 8 1 1 8 1 1 1 1 1 8 1 1 1 1 1 8 1 1 1 1 8 1
1 9 8 8 1 1 8 8 8 8 8 8 8 8 8 8 8 8 8 8 8 8 8 8 8 8 8 8 8 8 8 8 8 8 8 8 8 8 9 1
1 1 1 8 1 1 8 1 1 0 1 1 8 1 1 1 1 1 1 1 1 8 1 1 1 1 1 1 1 1 8 1 1 0 1 1 8 1 1 1
1 1 1 8 1 1 8 1 1 0 1 1 8 1 1 1 1 1 1 1 1 8 1 1 1 1 1 1 1 1 8 1 1 0 1 1 8 1 1 1
1 8 8 8 8 8 8 1 1 7 1 1 8 8 8 8 8 8 8 8 2 8 8 8 8 1 1 8 8 8 8 1 1 6 1 1 8 1 1 1
1 8 1 1 1 1 1 1 1 1 1 1 1 1 1 8 1 1 1 1 1 1 1 1 8 1 1 8 1 1 1 1 1 1 1 1 8 1 1 1
1 8 1 1 1 1 1 1 1 1 1 1 1 1 1 8 1 1 1 1 1 1 1 1 8 1 1 8 1 1 1 1 1 1 1 1 8 1 1 1
8 8 8 8 8 8 8 8 8 8 8 8 8 8 8 8 8 8 8 8 8 8 8 8 8 8 8 8 8 8 8 8 8 8 8 8 8 8 8 8
1 1 1 1 1 1 1 1 1 1 1 1 8 1 1 1 1 1 1 1 1 1 1 1 1 1 1 8 1 1 1 1 1 1 1 1 1 1 1 1
