1 1 1 1 1 1 1 1 1 1 1 1 8 1 1 1 1 1 1 1 1 1 1 1 1 1 1 8 1 1 1 1 1 1 1 1 1 1 1 1
8 9 8 8 8 8 8 8 8 8 8 8 8 1 1 1 1 1 1 1 1 1 1 1 1 1 1 8 8 8 11 8 8 8 8 8 8 8 9 8
1 8 1 1 1 1 1 1 1 1 1 1 8 1 1 1 1 1 1 1 1 1 1 1 1 1 1 8 1 1 1 1 1 1 1 1 1 1 8 1
1 8 1 1 1 1 1 1 1 1 1 1 8 8 8 8 8 8 8 8 8 8 8 8 8 8 8 8 1 1 1 1 1 1 1 1 1 1 8 1
8 8 8 8 8 8 8 8 8 8 8 8 8 1 1 8 1 1 6 0 0 7 1 1 8 1 1 8 8 8 8 8 8 8 8 8 8 8 8 8
1 8 1 1 1 1 1 1 1 8 1 1 1 1 1 8 1 1 0 0 0 0 1 1 8 1 1 1 1 1 8 1 1 1 1 1 1 1 8 1
1 8 1 1 1 1 1 1 1 8 1 1 1 1 1 8 1 1 0 0 0 0 1 1 8 1 1 1 1 1 8 1 1 1 1 1 1 1 8 1
1 8 8 8 8 8 8 8 8 8 8 8 8 1 1 8 1 1 17 7 6 9 1 1 8 1 1 8 8 8 8 8 8 8 8 8 8 8 8 1
1 1 1 1 1 8 1 1 1 1 1 1 8 1 1 8 1 1 19 19 19 19 1 1 8 1 1 8 1 1 1 1 1 1 8 1 1 1 1 1
1 1 1 1 1 8 1 1 1 1 1 1 8 1 1 8 1 1 1 1 1 1 1 1 8 1 1 8 1 1 1 1 1 1 8 1 1 1 1 1
8 8 8 8 8 8 1 1 1 8 8 8 8 8 8 8 1 1 1 1 1 1 1 1 8 8 8 8 8 8 8 1 1 1 8 8 8 8 8 8
1 8 1 1 1 8 1 1 1 8 1 1 1 1 1 8 8 8 8 8 8 8 8 8 8 1 1 1 1 1 8 1 1 1 8 1 1 1 8 1
1 8 1 1 1 8 8 8 8 8 1 1 1 1 1 8 1 1 1 1 1 1 1 1 8 1 1 1 1 1 8 8 8 8 8 1 1 1 8 1
1 8 1 1 1 1 1 1 1 8 8 8 8 8 8 8 1 1 1 1 1 1 1 1 8 8 8 8 8 8 8 1 1 1 1 1 1 1 8 1
1 8 1 1 1 1 1 1 1 8 1 1 1 1 1 8 1 1 1 1 1 1 1 1 8 1 1 1 1 1 8 1 1 1 1 1 1 1 8 1
1 8 1 1 1 1 1 1 1 8 1 1 1 1 1 8 8 8 8 8 8 8 8 8 8 1 1 1 1 1 8 1 1 1 1 1 1 1 8 1
1 8 8 8 12 8 8 8 8 8 8 8 8 1 1 1 1 1 8 1 1 8 1 1 1 1 1 8 8 8 8 8 8 8 8 8 8 8 8 1
1 8 1 1 1 1 8 1 1 1 1 1 8 1 1 1 1 1 8 1 1 8 1 1 1 1 1 8 1 1 1 1 1 8 1 1 1 1 8 1
1 8 1 1 1 1 8 1 1 1 1 1 8 1 1 1 1 1 8 1 1 8 1 1 1 1 1 8 1 1 1 1 1 8 1 1 1 1 8 1
1 9 8 8 1 1 8 0 0 0 0 0 8 8 8 8 8 8 8 8 8 8 8 8 8 8 8 8 8 8 8 8 8 0 0 0 8 8 9 1
1 1 1 8 1 1 8 1 1 0 0 1 1 8 1 1 1 1 1 1 1 1 8 1 1 1 1 1 1 1 8 1 1 0 0 1 1 8 1 1
1 1 1 8 1 1 8 1 1 0 0 1 1 8 1 1 1 1 1 1 1 1 8 1 1 1 1 1 1 1 8 1 1 0 0 1 1 8 1 1
1 8 8 8 8 8 8 1 1 4 0 1 1 8 8 8 8 8 8 8 2 8 8 8 8 1 1 8 8 8 8 1 1 0 5 1 1 8 1 1
1 8 1 1 1 1 1 1 1 1 1 1 1 1 1 8 1 1 1 1 1 1 1 1 8 1 1 8 1 1 1 1 1 1 1 1 1 8 1 1
1 8 1 1 1 1 1 1 1 1 1 1 1 1 1 8 1 1 1 1 1 1 1 1 8 1 1 8 1 1 1 1 1 1 1 1 1 8 1 1
1 8 8 8 8 8 8 8 8 8 8 8 8 8 8 8 8 8 8 8 8 8 8 8 8 8 8 8 8 8 8 8 8 8 8 8 8 8 1 1
1 1 1 1 1 1 1 1 1 1 1 1 1 1 1 1 1 1 1 1 1 1 1 1 1 1 1 1 1 1 1 1 1 1 1 1 1 1 1 1
