1 1 1 1 1 1 1 1 1 1 1 1 1 1 1 1 8 1 1 8 1 1 1 1 1 1 1 1 1 1 1 1 1 1 1 1 1 1 1 1
8 8 8 8 8 8 8 8 8 8 8 8 8 8 8 8 13 8 8 13 8 8 8 8 8 8 8 8 8 8 8 8 8 8 8 8 1 1 8 8
1 1 1 1 1 1 1 1 1 1 1 1 1 1 1 1 8 1 1 1 1 1 1 1 1 1 8 1 1 1 1 1 1 1 1 1 1 1 8 1
1 1 1 1 1 1 1 1 1 1 1 1 1 1 1 1 8 1 1 1 1 1 1 1 1 1 8 1 1 1 1 1 1 1 1 1 1 1 8 1
4 8 8 8 8 8 8 8 8 8 8 8 8 8 8 8 8 8 8 8 8 8 8 8 8 8 8 1 1 8 8 8 8 8 8 8 8 8 8 8
1 8 1 1 8 1 1 1 1 1 1 1 1 1 1 1 1 1 1 1 1 1 1 1 1 1 8 1 1 1 1 1 1 1 1 1 1 1 1 1
1 8 1 1 8 1 1 1 1 1 1 1 1 1 1 1 1 1 1 1 1 1 1 1 1 1 8 1 1 1 1 1 1 1 1 1 1 1 1 1
1 15 8 8 8 1 1 1 1 8 8 8 8 1 1 1 1 1 1 1 1 1 1 1 1 1 8 8 8 0 0 0 0 0 0 0 5 16 1 1
1 1 1 1 1 1 1 1 1 8 1 1 8 1 1 8 8 8 8 0 8 8 8 8 1 1 8 1 1 1 1 1 1 1 1 1 1 1 1 1
1 1 1 1 1 1 1 8 8 8 1 1 8 1 1 8 1 1 1 0 1 1 1 8 1 1 8 1 1 1 1 1 1 1 1 1 1 1 1 1
8 8 8 8 8 1 1 8 1 1 1 1 8 1 1 8 1 1 1 7 1 1 1 8 1 1 8 8 8 8 8 8 8 8 8 8 8 8 8 8
1 8 1 1 8 1 1 8 1 1 1 1 8 1 1 8 1 1 4 6 7 1 1 8 1 1 1 1 1 1 1 1 1 1 1 1 1 1 1 1
1 8 1 1 8 8 8 8 8 8 1 1 8 1 1 8 1 1 1 1 1 1 1 8 1 1 1 1 1 1 1 1 1 1 1 1 1 1 1 1
1 8 1 1 8 1 1 1 1 8 1 1 8 1 1 8 1 1 1 1 1 1 1 8 1 1 1 1 1 1 1 1 1 1 8 8 8 9 1 1
1 8 1 1 8 1 1 1 1 8 1 1 8 8 8 8 8 8 8 8 8 8 8 8 8 8 8 8 8 8 8 8 1 1 8 1 1 8 1 1
1 8 1 1 8 8 8 1 1 8 1 1 8 1 1 1 1 1 1 8 1 1 8 1 1 8 1 1 8 1 1 8 1 1 8 1 1 8 1 1
1 8 1 1 1 1 8 1 1 8 1 1 8 1 1 1 1 1 1 8 1 1 10 1 1 10 1 1 8 1 1 14 1 1 8 1 1 8 1 1
1 8 1 1 1 1 8 1 1 8 1 1 8 1 1 1 1 1 1 8 1 1 1 1 1 1 1 1 8 1 1 1 1 1 8 1 1 8 1 1
1 11 8 8 8 8 8 1 1 8 8 8 8 8 8 8 8 1 1 8 1 1 1 1 1 1 1 1 8 1 1 1 1 1 8 1 1 8 1 1
1 1 1 8 1 1 1 1 1 8 1 1 1 1 1 1 8 1 1 8 1 1 8 8 8 8 8 8 8 8 8 8 8 8 8 1 1 8 1 1
1 1 1 8 1 1 1 1 1 8 1 1 1 1 1 1 8 1 1 8 1 1 1 1 1 8 1 1 8 1 1 1 1 1 8 1 1 8 1 1
1 1 1 8 1 1 1 1 1 8 1 1 1 1 1 1 8 1 1 8 1 1 1 1 1 8 1 1 8 1 1 1 1 1 8 1 1 8 1 1
1 8 8 8 8 8 8 8 8 8 1 1 8 8 8 8 8 1 1 8 8 8 8 8 8 8 1 1 8 8 8 8 8 8 8 1 1 8 1 1
1 8 1 1 1 1 1 1 1 1 1 1 8 1 1 1 8 1 1 8 1 1 8 1 1 1 1 1 1 1 1 1 1 1 8 1 1 8 1 1
1 8 1 1 1 1 1 1 1 1 1 1 8 1 1 1 10 8 8 10 1 1 8 1 1 1 1 1 1 1 1 1 1 1 8 1 1 8 1 1
1 8 8 8 8 2 8 8 8 8 8 8 8 1 1 1 8 1 1 8 1 1 8 8 8 8 8 8 8 8 8 8 8 8 8 8 8 8 1 1
1 1 1 1 1 1 1 1 1 1 1 1 1 1 1 1 8 1 1 8 1 1 1 1 1 1 1 1 1 1 1 1 1 1 1 1 1 1 1 1
