1 1 1 1 1 1 1 1 1 1 1 1 8 1 1 1 1 1 1 1 1 1 1 1 1 1 1 8 1 1 1 1 1 1 1 1 1 1 1 1
8 9 6 7 7 7 6 7 6 6 6 7 6 1 1 1 1 1 1 1 1 1 1 1 1 1 1 7 7 7 7 7 7 7 7 7 7 6 6 7
1 8 1 1 1 1 1 1 1 1 1 1 6 7 6 6 7 7 7 7 7 7 7 7 7 7 7 7 7 7 7 1 1 1 1 1 1 6 6 1
1 8 1 1 1 1 1 1 1 1 1 6 7 7 7 7 7 7 6 7 6 7 6 7 7 7 7 7 7 7 7 1 1 1 1 1 1 6 6 1
6 6 6 6 6 6 6 6 6 6 6 6 7 7 7 6 6 7 6 7 6 7 6 7 7 6 7 7 7 6 6 6 6 6 6 6 6 6 6 8
1 1 1 1 1 1 1 1 1 1 1 1 1 1 1 1 1 7 7 7 7 7 7 7 7 7 7 7 7 7 7 1 1 1 1 1 1 1 8 1
1 1 1 1 1 1 1 1 1 1 1 1 1 1 1 1 1 1 1 1 1 1 1 1 1 1 1 1 1 7 7 1 1 1 1 1 1 1 8 1
1 8 8 8 8 8 8 8 8 1 1 8 8 1 1 1 1 1 1 1 1 1 1 1 1 1 1 1 1 7 7 1 1 8 8 8 8 8 8 1
1 1 1 1 1 8 1 1 1 1 1 1 8 1 1 8 1 1 1 1 1 1 1 1 1 1 1 1 1 1 1 1 1 1 8 1 1 1 1 1
1 1 1 1 1 8 1 1 1 1 1 1 8 1 1 8 1 1 1 1 1 1 1 1 1 1 1 1 1 1 1 1 1 1 8 1 1 1 1 1
8 8 8 8 8 8 1 1 1 8 8 8 8 8 8 8 1 1 1 1 1 1 1 1 1 1 1 1 1 1 1 1 8 8 8 8 8 8 8 8
1 8 1 1 1 8 1 1 1 8 1 1 1 1 8 8 8 8 8 8 8 8 8 8 1 1 1 1 1 1 1 1 8 1 1 1 1 1 8 1
1 0 1 1 1 8 8 8 8 8 1 1 1 1 8 8 1 1 1 1 8 1 1 1 8 8 8 8 8 8 8 8 8 1 1 1 1 1 8 1
1 0 1 1 1 1 1 1 1 8 8 8 8 8 8 8 1 1 1 1 8 1 1 1 8 8 8 8 8 8 8 1 1 1 1 1 1 1 8 1
1 8 1 1 1 1 1 1 1 8 1 1 1 1 1 8 1 1 1 1 8 1 1 1 8 1 1 1 1 1 8 1 1 1 1 1 1 1 8 1
1 8 1 1 1 1 1 1 1 8 1 1 1 1 1 8 8 8 8 8 8 8 8 8 8 1 1 1 1 1 8 1 1 1 1 1 1 1 8 1
1 8 8 8 12 8 8 8 0 0 0 8 8 1 1 8 1 1 1 1 8 1 1 1 1 1 1 8 8 8 8 8 8 8 8 8 8 8 8 1
1 8 1 1 1 1 8 1 1 1 1 1 8 1 1 1 1 1 1 1 8 1 1 1 1 1 1 8 1 1 1 1 1 8 1 1 1 1 8 1
1 8 1 1 1 1 8 1 1 1 1 1 8 1 1 1 1 1 1 1 8 1 1 1 1 1 1 8 1 1 1 1 1 8 1 1 1 1 8 1
1 9 8 8 1 1 8 0 0 0 0 0 8 8 8 8 8 8 8 8 8 8 8 8 8 8 8 8 8 8 8 8 8 8 8 8 8 8 9 1
1 1 1 8 1 1 8 1 1 0 0 1 1 8 1 1 1 1 1 1 1 1 8 1 1 1 1 1 1 1 8 1 1 8 8 1 1 8 1 1
1 1 1 8 1 1 8 1 1 0 0 1 1 8 1 1 1 1 1 1 1 1 8 1 1 1 1 1 1 1 8 1 1 8 8 1 1 8 1 1
1 8 8 8 8 8 8 1 1 0 0 1 1 8 8 8 8 8 8 8 2 8 8 8 8 1 1 8 8 8 8 1 1 8 8 1 1 8 1 1
1 8 1 1 1 1 1 1 1 1 1 1 1 1 1 8 1 1 1 1 1 1 1 1 8 1 1 8 1 1 1 1 1 1 1 1 1 8 1 1
1 8 1 1 1 1 1 1 1 1 1 1 1 1 1 8 1 1 1 1 1 1 1 1 8 1 1 8 1 1 1 1 1 1 1 1 1 8 1 1
1 19 8 8 8 8 8 8 8 8 8 8 8 8 8 8 8 8 8 8 8 8 8 8 8 8 8 8 8 8 8 8 8 8 8 8 8 8 1 1
1 1 1 1 1 1 1 1 1 1 1 1 1 1 1 1 1 1 1 1 1 1 1 1 1 1 1 1 1 1 1 1 1 1 1 1 1 1 1 1
